11111111111111111111111111111111111111111111111111111111111111
10000000000000000000000000000000000000000000000000000000E01
1010001011001010001111001111011111010100000100
10100010100010100010001010001010001011000010110000101
10100010100010100010001010001010001010100010101000101
1011111011101010001111001111001000101001001010010010001
10100010100010100010001010100010001010001010100010101
10100010100010100010001010010010001010000110100001101
10100010111010111011110010001011111010001010000010001
1P000000000000000000000000000000000000000000000000000000000C01
11111111111111111111111111111111111111111111111111111111111111